1 1 1 1 1 1 1 1 1 1 1 1 1 1 1 1 1 1 1 1 1 1 1 1 1 1 1 1 1 1 1 1 1 1 1 1 1 1 1 1 1 1 1 1 1 1 1 1 1 1
1 1 1 1 1 1 1 1 1 1 1 1 1 1 1 1 1 1 1 1 1 1 1 1 1 1 1 1 1 1 1 1 1 1 1 1 1 1 1 1 1 1 1 1 1 1 1 1 1 1
1 1 1 2 1 1 2 1 2 1 1 2 1 1 2 1 1 2 1 2 1 1 2 1 1 2 1 1 2 1 1 2 1 1 2 1 1 2 1 1 2 1 1 2 1 1 2 1 1 1
1 1 1 1 1 1 1 1 1 1 1 1 1 1 1 1 1 1 1 1 1 1 1 1 1 1 1 1 1 1 1 1 1 1 1 1 1 1 1 1 1 1 1 1 1 1 1 1 1 1
1 1 1 2 1 1 2 2 7 1 1 4 5 5 5 5 5 5 5 5 5 5 5 5 5 5 5 5 5 5 5 5 5 5 6 1 1 8 3 1 2 1 1 2 1 1 2 1 1 1
1 1 1 1 1 1 16 3 7 1 1 8 3 1 1 1 1 1 1 1 1 1 1 1 1 1 1 1 1 1 1 1 1 3 7 1 1 8 3 16 1 1 1 1 1 1 1 1 1 1
1 1 1 2 1 33 2 3 7 1 1 8 3 1 2 1 1 2 1 2 1 1 2 1 1 2 1 1 2 1 1 2 1 3 7 1 1 8 3 1 33 1 1 2 1 1 2 1 1 1
1 1 1 1 1 1 16 3 7 1 1 8 3 1 1 1 1 1 1 1 1 1 1 1 1 1 1 1 1 1 1 1 1 3 7 1 1 8 3 16 1 1 1 1 1 1 1 1 1 1
1 1 1 2 1 1 2 3 7 1 1 8 3 1 2 1 1 2 1 2 1 1 2 1 1 2 1 1 2 1 1 2 1 3 7 1 1 8 3 1 2 1 1 2 1 1 2 1 1 1
1 1 1 1 1 1 16 3 7 1 1 8 3 1 1 1 1 1 1 1 1 1 1 1 1 1 1 1 1 1 1 1 1 3 7 1 1 8 3 16 33 1 1 1 1 1 1 1 1 1
1 1 1 2 1 1 2 3 7 1 1 8 3 1 2 1 1 2 1 2 1 1 2 1 1 2 1 1 2 1 1 2 1 3 7 1 1 8 3 1 2 1 1 2 1 1 2 1 1 1
1 1 1 1 1 1 16 3 7 1 1 8 3 1 1 1 1 1 1 1 1 1 1 1 1 1 1 1 1 1 1 1 1 3 7 1 1 8 3 16 33 1 1 1 1 1 1 1 1 1
1 1 1 2 1 1 2 3 7 1 1 8 3 1 2 1 1 2 1 2 1 1 2 1 1 2 1 1 2 1 1 2 1 3 7 1 1 8 3 1 2 1 1 2 1 1 2 1 1 1
1 1 1 1 1 1 16 3 7 1 1 8 3 1 1 1 1 1 1 1 1 1 1 1 1 1 1 1 1 1 1 1 1 3 7 1 1 8 3 16 1 1 1 1 1 1 1 1 1 1
1 1 1 2 1 33 2 3 7 1 1 8 3 1 2 1 1 2 1 2 1 1 2 1 1 2 1 1 2 1 1 2 1 3 7 1 1 8 3 1 2 1 1 2 1 1 2 1 1 1
1 1 1 1 1 1 16 3 7 1 1 8 3 1 1 1 1 1 1 1 1 1 1 1 1 1 1 1 1 1 1 1 1 3 7 1 1 8 3 16 1 1 1 1 1 1 1 1 1 1
1 1 1 2 1 1 2 3 7 1 1 8 3 1 2 1 1 2 1 2 1 1 2 1 1 2 1 1 2 1 1 2 1 3 7 1 1 8 3 1 2 1 1 2 1 1 2 1 1 1
1 1 1 1 1 1 16 3 7 1 1 8 3 1 1 1 1 1 1 1 1 1 1 1 1 1 1 1 1 1 1 1 1 3 7 1 1 8 3 16 1 1 1 1 1 1 1 1 1 1
1 1 1 2 1 33 2 3 7 1 1 8 3 1 2 1 1 2 1 2 1 1 2 1 1 2 1 1 2 1 1 2 1 3 7 1 1 8 3 1 2 33 1 2 1 1 2 1 1 1
1 1 1 1 1 1 16 3 7 1 1 8 3 1 1 1 1 1 1 1 1 1 1 1 1 1 1 1 1 1 1 1 1 3 7 1 1 8 3 16 1 1 1 1 1 1 1 1 1 1
1 1 1 2 1 1 2 3 7 1 1 8 3 1 2 1 1 2 1 2 1 1 2 1 1 2 1 1 2 1 1 2 1 3 7 1 1 8 3 1 2 1 1 2 1 1 2 1 1 1
1 1 1 1 1 1 16 3 7 1 1 9 10 10 10 10 10 10 10 10 10 10 10 10 10 10 10 10 10 10 10 10 10 11 7 1 1 8 3 16 1 1 1 1 1 1 1 1 1 1
1 1 1 2 1 1 2 1 2 1 1 2 1 1 2 1 1 2 1 2 1 1 2 1 1 2 1 1 2 1 1 2 1 1 2 1 1 2 1 1 2 1 1 2 1 1 2 1 1 1
1 1 1 1 1 1 1 1 1 1 1 1 1 1 1 1 1 1 1 1 1 1 1 1 1 1 1 1 1 1 1 1 1 1 1 1 1 1 1 1 1 1 1 1 1 1 1 1 1 1
1 1 1 2 1 1 2 1 2 1 1 2 1 1 2 1 1 2 1 2 1 1 2 1 1 2 1 1 2 1 1 2 1 1 2 1 1 2 1 1 2 1 1 2 1 1 2 1 1 1
1 1 1 1 1 1 16 1 1 1 1 1 1 1 1 1 1 1 1 1 1 1 1 1 1 1 1 1 1 1 16 1 1 1 1 1 1 1 1 1 1 1 1 1 1 1 1 1 1 1
1 1 1 2 1 1 2 1 2 1 1 2 1 1 2 1 1 2 1 2 1 1 2 1 1 2 1 1 2 1 1 2 1 1 2 1 1 2 1 1 2 1 1 2 1 1 2 1 1 1
1 1 1 1 1 1 1 1 1 1 1 1 1 1 1 1 1 1 1 1 1 1 1 1 1 1 1 1 1 1 1 1 1 1 1 1 1 1 1 1 1 1 1 1 1 1 1 1 1 1
1 1 1 2 1 1 2 1 2 1 1 2 1 1 2 1 1 2 1 2 1 1 2 1 1 2 1 1 2 1 1 2 1 1 2 1 1 2 1 1 2 1 1 2 1 1 2 1 1 1
1 1 1 1 1 1 1 1 1 1 1 16 1 1 1 1 1 1 1 1 1 1 1 1 1 1 1 1 1 1 1 1 1 1 1 1 1 1 1 1 1 1 1 1 1 1 1 1 1 1
1 1 1 20 21 21 21 21 21 21 21 21 21 21 22 1 1 2 1 2 1 1 2 1 1 2 1 1 2 1 1 2 1 1 2 1 1 2 1 1 2 1 1 2 1 1 2 1 1 1
1 1 1 23 18 19 18 19 18 19 18 19 18 19 24 1 1 1 1 1 1 1 1 1 1 1 1 1 1 1 1 1 1 1 1 1 1 1 1 1 1 1 1 1 1 1 1 1 1 1
1 1 1 23 19 18 19 18 19 18 19 18 19 18 24 1 1 2 1 2 1 1 2 1 1 2 1 1 2 1 1 2 1 1 2 1 1 2 1 1 2 1 1 2 1 1 2 1 1 1
1 1 1 23 18 19 18 19 18 19 18 19 18 19 24 1 1 1 1 1 1 1 1 1 1 1 1 1 1 1 1 1 1 1 1 1 1 1 1 1 1 1 1 1 1 1 1 1 1 1
1 1 1 23 19 18 19 18 19 18 19 18 19 18 24 1 1 33 1 2 1 1 2 1 1 2 1 1 2 1 1 2 1 16 2 1 1 2 1 1 2 1 1 2 1 1 2 1 1 1
1 1 1 23 18 19 18 19 18 19 18 19 18 19 24 1 1 1 1 1 1 1 1 1 1 1 1 1 1 1 1 1 1 1 1 1 1 1 1 1 1 1 1 1 1 1 1 1 1 1
1 1 1 23 19 18 19 18 19 18 19 18 19 18 24 1 1 2 1 2 1 1 2 1 1 2 1 1 2 1 1 2 1 1 2 1 1 2 1 1 2 1 1 2 1 1 2 1 1 1
1 1 1 23 18 19 18 19 18 19 18 19 18 19 24 1 1 1 1 1 1 1 1 1 1 1 1 1 1 1 1 1 1 1 1 1 1 1 1 1 1 1 1 1 1 1 1 1 1 1
1 1 1 25 26 26 26 26 26 26 26 26 26 26 27 1 1 2 1 1 2 1 1 2 1 1 2 1 1 2 1 1 2 1 1 2 1 1 2 1 1 2 1 2 1 2 1 1 1 1
1 1 1 1 1 1 1 1 1 1 1 1 1 1 16 1 1 1 1 1 1 1 1 1 1 1 1 1 1 1 1 1 1 1 1 1 1 1 1 1 1 1 1 1 1 1 1 1 1 1
1 1 1 2 1 1 2 1 2 1 1 2 1 1 2 1 1 2 1 2 1 1 2 1 1 2 1 1 2 1 1 2 1 1 2 1 1 2 1 1 2 1 1 2 1 1 2 1 1 1
1 1 1 1 1 1 1 1 1 1 1 1 1 1 1 1 1 1 1 1 1 1 1 1 1 1 1 1 1 1 1 1 1 1 1 1 1 1 1 1 1 1 1 1 1 1 1 1 1 1
1 1 1 2 1 1 2 1 2 1 1 2 1 1 2 1 1 2 1 2 1 1 2 1 1 2 1 1 2 1 1 2 1 1 2 1 1 2 1 1 2 33 1 2 1 1 2 1 1 1
1 1 1 1 1 1 1 1 1 1 1 1 1 1 1 1 1 1 1 1 1 1 1 1 1 1 1 1 1 1 1 1 1 1 1 1 1 1 1 1 1 1 1 1 1 1 1 1 1 1
1 1 1 2 1 1 2 1 2 1 16 2 1 1 2 1 1 2 1 2 1 1 2 1 1 2 1 1 2 1 1 2 1 1 2 1 1 2 1 1 2 1 1 2 1 1 2 1 1 1
1 1 1 1 1 1 1 1 1 1 1 1 1 1 1 1 1 1 1 1 1 1 1 1 1 1 1 1 1 1 1 1 1 1 1 1 1 1 1 1 1 1 1 1 1 1 1 1 1 1
1 1 1 2 1 1 2 1 2 1 1 2 1 1 2 1 1 2 1 2 1 1 2 1 1 2 1 1 2 1 1 2 1 1 2 1 1 2 1 1 2 1 16 2 1 1 2 1 1 1
1 1 1 1 1 1 1 16 1 1 1 1 1 1 1 1 1 1 1 1 1 1 1 16 1 1 1 1 1 1 1 1 1 1 1 1 1 1 1 1 1 1 1 1 1 1 1 1 1 1
1 1 1 2 1 1 2 1 2 1 1 2 1 1 2 1 1 2 1 2 1 1 2 1 1 2 1 1 2 1 1 2 1 1 2 1 1 2 1 1 2 1 1 2 1 1 2 1 1 1
1 1 1 1 1 1 1 1 1 1 1 1 1 1 1 1 1 1 1 1 1 1 1 1 1 1 1 1 1 1 1 1 1 1 1 1 1 1 1 1 1 1 1 1 1 1 1 1 1 1